111111111111111111
10000100C000C00111
1000000C000C001111
10000C10010000C001
10C000000000000001
1010100000C0000D01
11E100C00110000001
10100P0000000C0001
10000000C000000001
111111111111111111
