111111111111111111
100001000000000111
100000000000001111
100000100100000001
100000000000000001
100010000000000D01
10E000000110000001
10000P000000000001
100000000000000001
111111111111111111
