111111111111111111
10000100C000C00111
1000000C000C001111
10000C10010000C001
10C000000000000001
1000100000C0000D011
10E000C00110000001
10000P0004500C0001
10000000C000000001
11111111111111111111
