111111111111111111
100001D0C000C00111
100000DC000C001111
10000CD0010000C001
10C000D00000000001
100010D000C0000D01
10E000D00110000001
10000PD000000C0001
100000D0C000000001
111111111111111111
