111111111111111111
10000100C010C10111
1000000C000C101111
10000C10000000C001
111111111110111111
1000100000C0000101
10E000C01000000011
10000P00000D0C0001
10000000C000000001
111111111111111111
